HD FW EP EP FW FW EP EP FW EP EP EP FW EP
EP EP EP EP EP FW EP EP EP EP EP EP FW EP
EP EP UB EP EP UB EP FW UB FW EP UB FW EP
FW EP FW FW FW EP EP EP EP EP EP FW FW FW
EP EP EP EP FW EP EP EP EP EP EP EP EP EP
EP BC UB EP FW UB EP EP UB EP FW UB EP EP
EP EP EP FW FW EU EP FW EP EP FW EP EP FW
EP EP EP FW EP EP EP FW EP EP FW EP EP EP
EP EP UB FW EP UB EP EP UB EP EP UB FW EP
EP FW EP EP EP FW EP EP EP FW FW EP FW EP
FW EP EP EP EP FW EP EP EP EP EP EP FW EP
FW FW UB EP EP UB EP EP UB EP EP UB FW EP
EP EP EP FW EP FW EP EP FW EP EP FW EP EP
EP FW FW FW EP EP EP EP FW EP FW FW EP FW